111111111111111111111111111111111111111111111111111111111111
1E0B0B0000CBCB000CB00CB000CB0B00CB0000B0000BC0000CBC0BC00001
1B0BCB0BBBBB0B0BBB00BB00BB0B0C0B0BCB0BC0BB00B00BB00B00B0B0B1
1B0B0B00000000C0000BB00B0BBB0BBC0BB000B00CB0CB000B0CB0BB00C1
10000B0B0BBB0B0BB0B0BCB00B0B0BB0B000BCB00BB0BBBBBC0B00BC0BB1
10BB000B0BCBPB0B00B00000BB0B0BC000B00B00BC0000BC00BCB0000B01
10CB0BBB0B0CBC00BBB0BBBCBC000BB0B0CB000B00BBB0BB0B0000BBBB01
10BB0000B00BCB0B0000000BBB0B0B0000B00B0B00CB0BC00B0B0BC00001
1CBBBBB000BB00000BB0BCB0000B0B0BB0000CB00B0B0B0B000B0B0BBB01
1B0000CB0B0BBB0BCB00BBB0BB0B0B0BCB0B0B0BBC000B0BBBBB0B0BCB01
100B0B0B0B00000BBB0B0000CB0B0B000BCB0B00BBB0B00000000B0B0001
10BCB0000B0BCB0BCB00B0BBBBBB0BBBBBBBB0B0BCB00BB0B0B0BBBB0B01
10B0B0BB0000B00000BCB00BCB000BC00BC00000000B0B0000B000CBCBC1
1CB0B00BBBBBBBBBBBBBBB0B0B0BCB0B0B0BBBBBBBBBBBBCBBBBBBBB0BB1
1BB0BB0BCB00CB00000CBC0B00CB000BCB000B000BCBCB000B000B0000C1
1CB000000B0BBB0BBBBBBB0BBBBB0BBBBB0BCB0B0B0B0B0B0B0B0B0BBB01
10BBBBBB0B0000CB0000C0000BCB0BCB0B0BBB0BBB0B000B000BC00BCB01
1CBC0B0B0B0BBB0B0BBBBBBB0B0B0B0B00C0000BC00B0BBB0B0BBB0B0001
10B0B000000B0000000BC0CB0B0B0B0BB0B0B0BB0B0BC00B0B00B00BBBB1
1CB000BBBB0BBB0BBB0B0BBB0B0B0B0000B0BC0B0B0BBB0BBBBBB0000001
10BBB0BC00000B00C0000B00000B0BBBBBBBBB0B0BC00B000BC000BBBB01
1CBCB0BBBB0B0BBB0BBBBB0BBB0B000000C0000B0BBB0B0B0B0BBBCBCB01
10B0B00BCB0B0BCB00CB0000CB0B0B0BBBBBBB000BC00B0B0000000B0001
1CB0BB0B000B0B0B0BBB0B0B0C0B0B0BC00000CB0B0000CB0BBBBBBBBB01
10B0BC0B0B0B0B00C00B0B0B0B0B0B0B0BBBBBBBBB0BBBBB0BCB000B0001
1CB0BBB00B0B000BBB0B0B000B0B0B0B0BC00B0B000B000B0B0B0B000B01
10B00000BB0B0B0B0U0B0B0B000B0B0B000BCB000BCBB0BB00000BCBBB01
1CB0BBBBBB0BBB0BBBBB0B0BBB0B0B0B0BBBBB0B00B000BBBB0BCBBCB001
10000CBC000CB000CBC00B00CB000B00CBC0000BB000B0CBC00B00B00CB1
111111111111111111111111111111111111111111111111111111111111