111111111111111111111111111111111111111111111111111111111111
1E01010000C1C1000C100C1000C10100C10000100001C0000C1C01C00001
1101C101111101011100110011010C0101C101C011001001100100101011
11010100000000C0000110010111011C011000100C10C100010C101100C1
100001010111010110101C100101011010001C10011011111C01001C0111
1011000101C1P10100100000110101C0001001001C00001C001C10000101
10C10111010C1C001110111C1C00011010C1000100111011010000111101
101100001001C10100000001110101000010010100C101C0010101C00001
1C1111100011000001101C100001010110000C1001010101000101011101
110000C101011101C100111011010101C10101011C00010111110101C101
100101010100000111010000C101010001C1010011101000000001010001
101C10000101C101C100101111110111111110101C100110101011110101
1010101100001000001C1001C10001C001C0000000010100001000C1C1C1
1C10100111111111111111010101C101010111111111111C111111110111
11101101C100C100000C1C0100C10001C100010001C1C1000100010000C1
1C1000000101110111111101111101111101C10101010101010101011101
10111111010000C10000C00001C101C101011101110100010001C001C101
1C1C010101011101011111110101010100C00001C0010111010111010001
10101000000100000001C0C101010101101010110101C001010010011111
1C10001111011101110101110101010000101C0101011101111110000001
1011101C00000100C0000100000101111111110101C0010001C000111101
1C1C101111010111011111011101000000C0000101110101010111C1C101
10101001C10101C100C10000C10101011111110001C00101000000010001
1C10110100010101011101010C010101C00000C1010000C1011111111101
10101C0101010100C001010101010101011111111101111101C100010001
1C10111001010001110101000101010101C0010100010001010101000101
101000001101010100010101000101010001C10001C11011000001C11101
1C10111111011101111101011101010101111101001000111101C11C1001
10000C1C000C1000C1C00100C1000100C1C00001100010C1C00100100C11
111111111111111111111111111111111111111111111111111111111111