1111111
1CP00C1
1C1E1B1
1U0C0C1
1111111
