1111111
1C1P001
1000111
1110C01
1110111
1110E01
1111111
