11111111111111111111111111111111111111111111111111
1C000001C00001C10110C00010000000C100C0000C10000C01
100P1C01110001010001000010C00110001000111110010001
1011100001110000001001100000011100100000000C000111
1000000110010000100C0000111100C1100001100011000001
10C0110C0001000C10C00001E0001000000001100011000101
10001100100001000100000011100100010100010000000101
1000000000011100100001000001001110010010C010001001
100C01000000100C00000100100C10000001C01000100010C1
11111111111111111111111111111111111111111111111111
