11111111111111111111111111111111111111111111111111
1C000001C00001C10110C0001000B000C1B0C0000C10000C01
100P1C01110001010001000010C001100B1000111110010001
1011100001110000001001100000011100100000000C000111
1000000110010000100C0000111100C1100001100011000001
10C0110C0001000C10CB0001E0001000000001100011000101
10001100100001000100B00011100100010100010000000101
10000000000111001B0U01000001001110010010C010001001
100CB1000000100C000001B0100C100000B1C01000100010C1
11111111111111111111111111111111111111111111111111
