1111111111
1P000000E1
100C000001
1000000001
100C000001
10000000U1
1111111111