11111111
1E000C11
1C0001P1
11111111