11111111
1P000C11
1C0001E1
11111111