11111111
1P010C11
1C0010E1
11111111