11111111
1P000E11
1C0001C1
11111111