1111111111111111111111111111111111111111111111111111111111111
1E01010000C1C1000C100C1000C10100C10000100001C0000C1C01C000011
1101C101111101011100110011010C0101C101C0110010011001001010111
11010100000000C0000110010111011C011000100C10C100010C101100C11
100001010111010110101C100101011010001C10011011111C01001C01111
1011000101C1P10100100000110101C0001001001C00001C001C100001011
10C10111010C1C001110111C1C00011010C10001001110110100001111011
101100001001C10100000001110101000010010100C101C0010101C000011
1C1111100011000001101C100001010110000C10010101010001010111011
110000C101011101C100111011010101C10101011C00010111110101C1011
100101010100000111010000C101010001C10100111010000000010100011
101C10000101C101C100101111110111111110101C1001101010111101011
1010101100001000001C1001C10001C001C0000000010100001000C1C1C11
1C10100111111111111111010101C101010111111111111C1111111101111
11101101C100C100000C1C0100C10001C100010001C1C1000100010000C11
1C1000000101110111111101111101111101C101010101010101010111011
10111111010000C10000C00001C101C101011101110100010001C001C1011
1C1C010101011101011111110101010100C00001C00101110101110100011
10101000000100000001C0C101010101101010110101C0010100100111111
1C10001111011101110101110101010000101C01010111011111100000011
1011101C00000100C0000100000101111111110101C0010001C0001111011
1C1C101111010111011111011101000000C0000101110101010111C1C1011
10101001C10101C100C10000C10101011111110001C001010000000100011
1C10110100010101011101010C010101C00000C1010000C10111111111011
10101C0101010100C001010101010101011111111101111101C1000100011
1C10111001010001110101000101010101C00101000100010101010001011
101000001101010100010101000101010001C10001C11011000001C111011
1C10111111011101111101011101010101111101001000111101C11C10011
10000C1C000C1000C1C00100C1000100C1C00001100010C1C00100100C111
1111111111111111111111111111111111111111111111111111111111111
1111111111111111111111111111111111111111111111111111111111111